50
10
255 255 255
205 205 205
1 1
0 0 0 0 0 B 0 0 0 B 
0 0 0 0 0 0 0 0 0 0 
0 0 0 B B B B 0 0 0 
0 0 0 B B B B 0 0 B 
B 0 0 0 0 0 0 0 0 B 
0 0 0 0 0 0 0 0 B 0 
0 0 0 B B B B 0 B 0 
0 0 0 B B B B 0 B 0 
0 0 B B B B B 0 B 0 
0 0 0 0 0 0 0 0 0 0 
