10
10 
1 
7 1 
1 1 1 
1 3 1 1 
1 1 1 1 1 
1 1 1 1 
1 5 1 
1 1 
9 
10 
1 
7 1 
1 1 1 
1 3 1 1 
1 1 1 1 1 
1 1 1 1 
1 5 1 
1 1 
9 
